1111111111111
10C000P0E0011
100001000C001
1100010000011
10000011E0011
10000100CC001
1111111111111
