1111111111111
1E000000E0001
1000P11000011
100011100E001
10E0111000011
100C000000001
1111111111111